2323222222
2120000003
2022200222
2004200003
2000204002
2000000002
2222222022
2000200002
3000004042
2222222222